16 13
200 120
2 2 2 2 2 2 2 2 2 2 2 2 2 2 2 2
2 14 11 11 11 11 11 11 11 11 11 11 0 11 14 2
2 14 0 0 0 0 0 0 0 0 0 0 0 0 14 2
2 14 0 0 0 0 0 0 0 0 0 0 0 0 14 2
2 14 0 0 0 0 0 0 0 0 0 0 0 0 14 2
2 14 0 0 0 0 0 0 0 0 0 0 0 0 14 2
2 14 0 0 0 0 0 0 0 0 0 0 0 0 14 2
2 14 0 0 0 0 0 0 0 0 0 0 0 0 14 2
2 14 0 0 0 0 0 0 0 0 0 0 0 0 14 2
2 14 0 0 0 0 0 0 0 0 0 0 0 0 14 2
2 11 11 11 11 11 11 11 11 11 11 11 11 11 11 2
2 2 2 2 2 2 2 2 2 2 2 2 2 2 2 2
2 2 2 2 2 2 2 2 2 2 2 2 2 2 2 2