24 25
150 1394
2 2 2 2 2 2 2 2 2 2 2 2 2 2 2 2 2 2 2 2 2 2 2 2
2 2 2 2 2 2 2 2 2 2 2 2 2 2 14 11 0 11 11 11 11 11 14 2
2 2 2 2 2 2 2 2 2 2 2 2 2 2 14 0 0 0 0 0 0 0 14 2
2 2 2 2 2 2 2 2 2 2 2 2 2 2 14 0 0 0 0 0 0 0 14 2
2 2 2 2 2 2 2 2 2 2 2 2 2 2 14 0 0 0 0 0 0 0 14 2
2 2 2 2 2 2 2 2 2 2 2 2 2 2 11 11 11 11 14 0 14 11 11 2
2 2 2 2 2 2 2 2 2 2 2 2 2 2 2 2 2 2 14 3 14 2 2 2
2 2 2 2 2 2 2 2 2 2 2 2 2 2 14 11 11 11 11 0 11 11 14 2
2 2 2 2 2 2 2 2 2 2 2 2 2 2 14 0 0 0 0 0 0 0 14 2
2 2 2 2 2 2 2 2 2 2 2 2 2 2 14 0 0 0 0 0 0 0 14 2
2 2 2 2 2 2 2 2 2 2 2 2 2 2 14 0 0 0 0 0 0 0 14 2
2 14 11 11 11 11 11 11 11 11 11 11 11 11 11 0 0 0 0 0 0 0 14 2
2 14 0 0 0 0 0 0 0 0 0 0 0 0 0 0 0 0 0 0 0 0 14 2
2 14 0 0 0 0 0 0 0 0 0 0 0 0 0 0 0 0 0 0 0 0 14 2
2 14 0 0 0 0 0 0 0 0 0 0 0 0 0 0 0 0 0 0 0 0 14 2
2 14 0 0 0 0 0 0 0 0 0 0 0 0 0 0 0 0 0 0 0 0 14 2
2 14 0 0 0 0 0 0 0 0 0 0 0 0 0 0 0 0 0 0 0 0 14 2
2 14 0 0 0 0 0 0 0 0 0 0 0 0 0 0 0 0 0 0 0 0 14 2
2 11 11 14 0 14 11 11 11 11 11 11 11 11 11 11 11 11 11 11 11 11 11 2
2 2 2 14 0 14 2 2 2 2 2 2 2 2 2 2 2 2 2 2 2 2 2 2
2 14 11 11 3 11 11 14 2 2 2 2 2 2 2 2 2 2 2 2 2 2 2 2
2 14 0 0 0 0 0 14 2 2 2 2 2 2 2 2 2 2 2 2 2 2 2 2
2 14 0 0 0 0 0 14 2 2 2 2 2 2 2 2 2 2 2 2 2 2 2 2
2 14 0 0 0 0 0 14 2 2 2 2 2 2 2 2 2 2 2 2 2 2 2 2
2 11 11 11 11 11 11 11 2 2 2 2 2 2 2 2 2 2 2 2 2 2 2 2
2 2 2 2 2 2 2 2 2 2 2 2 2 2 2 2 2 2 2 2 2 2 2 2
2 2 2 2 2 2 2 2 2 2 2 2 2 2 2 2 2 2 2 2 2 2 2 24 4 4 4 4 4 4