48 22
150 1060
2 2 2 2 2 2 2 2 2 2 2 2 2 2 2 2 2 2 2 2 2 2 2 2 2 2 2 2 2 2 2 2 2 2 2 2 2 2 2 2 2 2 2 2 2 2 2 2
2 2 2 2 2 2 2 2 2 2 14 11 11 11 11 11 11 11 11 11 11 11 14 2 2 2 2 2 2 2 2 2 2 2 2 2 2 2 2 2 2 2 2 2 2 2 2 2
2 2 2 2 2 2 2 2 2 2 14 0 0 0 0 0 0 0 0 0 0 0 14 2 14 2 14 2 14 2 14 2 14 11 11 11 11 11 14 2 2 2 2 2 2 2 2 2
2 2 2 2 2 2 2 2 2 2 14 0 0 0 0 0 0 0 0 0 0 0 11 11 11 11 11 11 11 11 11 11 11 0 0 0 0 0 14 2 2 2 2 2 2 2 2 2
2 2 2 2 2 2 2 2 2 2 14 0 0 0 0 0 0 0 0 0 0 0 0 0 0 0 0 0 0 0 0 0 0 0 0 0 0 0 14 2 2 2 2 2 2 2 2 2
2 2 2 2 2 2 2 2 2 2 14 0 0 0 0 0 0 0 0 0 0 0 0 0 0 0 0 0 0 0 0 0 0 0 0 0 0 0 14 2 2 2 2 2 2 2 2 2
2 2 2 2 2 2 2 2 2 2 14 0 0 0 0 0 0 0 0 0 0 0 14 11 14 11 14 11 14 11 14 11 14 0 0 0 0 0 14 2 2 2 2 2 2 2 2 2
2 2 2 2 2 2 2 2 2 2 14 0 0 0 0 0 0 0 0 0 0 0 14 4 11 4 11 4 11 4 11 4 11 14 12 14 11 11 11 2 2 2 2 2 2 2 2 2
2 2 2 2 2 2 2 2 2 14 11 0 0 0 0 14 11 11 11 11 11 11 11 4 4 4 4 4 4 4 4 4 4 14 3 14 2 2 2 2 2 2 2 2 2 2 2 2
2 2 2 2 2 2 2 2 14 11 0 0 0 0 14 11 2 2 2 2 2 2 2 2 2 2 2 2 2 2 2 2 2 14 0 14 2 2 2 2 2 2 2 2 2 2 2 2
2 2 2 2 2 2 2 14 11 0 0 0 0 14 11 2 2 2 2 2 2 2 2 2 2 2 2 2 2 2 2 2 2 14 3 14 2 2 2 2 2 2 2 2 2 2 2 2
2 2 2 2 2 2 14 11 0 0 0 0 14 11 2 2 2 2 2 2 2 2 2 2 2 2 2 2 2 2 2 2 2 14 0 14 2 2 2 2 2 2 2 2 2 2 2 2
2 2 2 2 2 14 11 0 0 0 0 14 11 2 2 2 2 2 2 2 2 2 2 2 2 2 2 14 11 11 11 11 11 11 12 11 14 2 2 2 2 2 2 2 2 2 2 2
2 2 2 2 14 11 0 0 0 0 14 11 2 2 2 2 2 2 2 2 2 2 2 2 2 2 2 14 0 0 0 0 0 0 0 0 14 2 2 2 2 2 2 2 2 2 2 2
2 2 2 14 11 0 0 0 0 14 11 2 2 2 2 2 2 2 2 2 2 2 2 2 2 2 2 14 0 0 0 0 0 0 0 0 14 2 2 2 14 11 11 11 0 11 14 2
2 2 14 11 0 0 0 0 14 11 2 2 2 2 2 2 2 2 2 2 2 2 2 2 2 2 2 14 0 0 0 0 0 0 0 0 14 2 2 2 14 0 0 0 0 0 14 2
2 14 11 0 0 0 0 14 11 2 2 2 2 2 2 2 2 2 2 2 2 2 2 2 2 2 2 14 0 0 0 0 0 0 0 0 14 2 2 2 14 0 0 0 0 0 14 2
2 14 0 0 0 0 14 11 2 2 2 2 2 2 2 2 2 2 2 2 2 2 2 2 2 2 2 14 0 0 0 0 0 0 0 0 13 11 11 11 11 0 0 0 0 0 14 2
2 14 0 0 0 0 14 2 2 2 2 2 2 2 2 2 2 2 2 2 2 2 2 2 2 2 2 14 0 0 0 0 0 0 0 0 0 0 0 0 0 0 0 0 0 0 14 2
2 14 0 0 0 0 14 2 2 2 2 2 2 2 2 2 2 2 2 2 2 2 2 2 2 2 2 14 0 0 0 0 0 0 0 0 14 0 0 0 0 0 0 0 0 0 14 2
2 11 11 11 11 11 11 2 2 2 2 2 2 2 2 2 2 2 2 2 2 2 2 2 2 2 2 11 11 11 11 11 11 11 11 11 11 11 11 11 11 11 11 11 11 11 11 2
2 2 2 2 2 2 2 2 2 2 2 2 2 2 2 2 2 2 2 2 2 2 2 2 2 2 2 2 2 2 2 2 2 2 2 2 2 2 2 2 2 2 2 2 2 2 2 2