40 21
1300 1000
2 2 2 2 2 2 2 2 2 2 2 2 2 2 2 2 2 2 2 2 2 2 2 2 2 2 2 2 2 2 2 2 2 2 2 2 2 2 2 2
2 2 2 2 2 2 2 2 2 2 2 2 2 2 2 2 2 2 2 2 2 2 2 2 2 2 2 2 2 2 2 2 2 2 2 2 2 2 2 2
2 2 2 2 2 2 2 2 2 2 2 2 2 2 2 2 14 11 11 11 0 11 11 11 11 14 2 2 2 2 2 2 14 11 11 11 11 11 14 2 2
2 2 14 11 11 11 11 11 14 2 2 2 2 2 2 14 0 0 0 0 0 0 0 0 14 2 2 2 2 2 2 14 0 0 0 0 0 14 2 2
2 2 14 0 0 0 0 0 11 11 11 11 11 11 11 11 0 0 0 0 0 0 0 0 11 11 11 11 11 11 11 11 0 0 0 0 0 14 2 2
2 2 14 0 0 0 0 0 0 0 0 0 0 0 0 0 0 0 0 0 0 0 0 0 0 0 0 0 0 0 0 0 0 0 0 0 0 14 2 2
2 2 14 0 0 0 0 0 0 0 0 0 0 0 0 0 0 0 0 0 0 0 0 0 0 0 0 0 0 0 0 0 0 0 0 0 0 14 2 2
2 2 14 0 0 0 0 0 14 14 11 14 11 14 11 14 0 0 0 0 0 0 0 0 14 14 11 14 11 14 11 14 0 0 0 0 0 14 2 2
2 2 14 0 0 0 0 0 14 11 4 11 4 11 4 14 0 0 0 0 0 0 0 0 14 11 4 11 4 11 4 11 11 11 11 11 11 11 2 2
2 2 11 11 11 11 11 11 11 2 2 2 2 2 2 14 0 0 0 0 0 0 0 0 14 2 2 2 2 2 2 2 2 2 2 2 2 2 2 2
2 2 2 2 2 2 2 2 2 2 2 2 2 2 2 14 0 0 0 0 0 0 0 0 14 2 2 2 2 2 2 2 2 2 2 2 2 2 2 2
2 2 2 2 2 2 2 2 2 2 2 2 2 2 2 11 11 11 14 0 0 14 11 11 11 2 2 2 2 2 2 2 2 2 2 2 2 2 2
2 2 2 2 2 2 2 2 2 2 2 2 2 2 2 2 2 2 2 14 3 3 14 2 2 2 2 2 2 2 2 2 2 2 2 2 2 2 2 2
2 2 2 2 2 2 2 2 2 2 2 2 2 2 2 2 2 2 2 14 3 3 14 2 2 2 2 2 2 2 2 2 2 2 2 2 2 2 2 2
2 2 2 2 2 2 2 2 2 2 2 2 2 2 2 2 2 14 11 11 3 3 11 11 14 2 2 2 2 2 2 2 2 2 2 2 2 2 2 2
2 2 2 2 2 2 2 2 2 2 2 2 2 2 2 2 2 14 0 0 0 0 0 0 14 2 2 2 2 2 2 2 2 2 2 2 2 2 2 2
2 2 2 2 2 2 2 2 2 2 2 2 2 2 2 2 2 14 0 0 0 0 0 0 14 2 2 2 2 2 2 2 2 2 2 2 2 2 2 2
2 2 2 2 2 2 2 2 2 2 2 2 2 2 2 2 2 14 0 0 0 0 0 0 14 2 2 2 2 2 2 2 2 2 2 2 2 2 2 2
2 2 2 2 2 2 2 2 2 2 2 2 2 2 2 2 2 11 11 11 11 11 11 11 11 2 2 2 2 2 2 2 2 2 2 2 2 2 2 2
2 2 2 2 2 2 2 2 2 2 2 2 2 2 2 2 2 2 2 2 2 2 2 2 2 2 2 2 2 2 2 2 2 2 2 2 2 2 2 2
2 2 2 2 2 2 2 2 2 2 2 2 2 2 2 2 2 2 2 2 2 2 2 2 2 2 2 2 2 2 2 2 2 2 2 2 2 2 2 2