30 32
632 1790
2 2 2 2 2 2 2 2 2 2 2 2 2 2 2 2 2 2 2 2 2 2 2 2 2 2 2 2 2 2
2 2 2 2 2 2 2 2 2 2 2 2 2 2 2 2 2 2 2 2 2 2 2 2 2 2 2 2 2 2
2 2 2 2 2 2 2 14 11 11 0 11 11 11 14 2 2 2 2 2 2 2 2 2 2 2 2 2 2 2
2 2 2 2 2 2 2 14 0 0 0 0 0 0 14 2 2 2 2 2 2 2 2 2 2 2 2 2 2 2
2 2 2 2 2 2 2 14 0 0 0 0 0 0 14 2 2 2 2 2 2 2 2 2 2 2 2 2 2 2
2 2 2 2 2 2 2 14 0 0 0 0 0 0 14 2 2 2 2 2 2 2 2 2 2 2 2 2 2 2
2 2 2 2 2 2 2 11 11 14 3 3 14 11 11 2 2 2 2 2 2 2 2 2 2 2 2 2 2 2
2 2 2 2 2 2 2 2 2 14 3 3 14 2 2 2 2 2 2 2 2 2 2 2 2 2 2 2 2 2
2 2 14 11 11 11 11 11 11 11 0 0 11 11 11 11 11 11 11 14 2 2 2 2 2 2 2 2 2 2
2 2 14 0 0 0 0 0 0 0 0 0 0 0 0 0 0 0 0 14 2 2 2 2 2 2 2 2 2 2
2 2 14 0 0 0 0 0 0 0 0 0 0 0 0 0 0 0 0 14 2 2 2 2 2 2 2 2 2 2
2 2 14 0 0 14 14 0 0 0 0 0 0 0 0 14 14 0 0 14 2 2 2 2 2 2 2 2 2 2
2 2 14 0 0 11 11 0 0 0 0 0 0 0 0 11 11 0 0 14 2 2 2 2 2 2 2 2 2 2
2 2 14 0 0 0 0 0 0 0 0 0 0 0 0 0 0 0 0 14 2 2 2 2 2 2 2 2 2 2
2 2 14 0 0 0 0 0 0 0 0 0 0 0 0 0 0 0 0 14 2 2 2 2 2 2 2 2 2 2
2 2 14 0 0 14 14 0 0 0 0 0 0 0 0 14 14 0 0 14 2 2 2 2 2 2 2 2 2 2
2 2 14 0 0 11 11 0 0 0 0 0 0 0 0 11 11 0 0 14 2 2 2 2 2 2 2 2 2 2
2 2 14 0 0 0 0 0 0 0 0 0 0 0 0 0 0 0 0 14 2 2 2 2 2 2 2 2 2 2
2 2 14 0 0 0 0 0 0 0 0 0 0 0 0 0 0 0 0 14 2 2 2 2 2 2 2 2 2 2
2 2 14 0 0 14 14 0 0 0 0 0 0 0 0 14 14 0 0 14 2 2 2 2 2 2 2 2 2 2
2 2 14 0 0 11 11 0 0 0 0 0 0 0 0 11 11 0 0 14 2 2 2 2 2 2 2 2 2 2
2 2 14 0 0 0 0 0 0 0 0 0 0 0 0 0 0 0 0 14 2 2 2 2 2 2 2 2 2 2
2 2 14 0 0 0 0 0 0 0 0 0 0 0 0 0 0 0 0 14 2 2 2 2 2 2 2 2 2 2
2 2 11 11 11 11 11 11 11 14 3 3 14 11 11 11 11 11 11 11 2 2 2 2 2 2 2 2 2 2
2 2 2 2 2 2 2 2 2 14 3 3 14 2 2 2 2 2 2 2 2 2 2 2 2 2 2 2 2 2
2 2 2 2 2 2 2 14 11 11 0 0 11 11 14 2 2 2 2 2 2 2 2 2 2 2 2 2 2 2
2 2 2 2 2 2 2 14 0 0 0 0 0 0 14 2 2 2 2 2 2 2 2 2 2 2 2 2 2 2
2 2 2 2 2 2 2 14 0 0 0 0 0 0 14 2 2 2 2 2 2 2 2 2 2 2 2 2 2 2
2 2 2 2 2 2 2 14 0 0 0 0 0 0 14 2 2 2 2 2 2 2 2 2 2 2 2 2 2 2
2 2 2 2 2 2 2 11 11 11 11 11 11 11 11 2 2 2 2 2 2 2 2 2 2 2 2 2 2 2
2 2 2 2 2 2 2 2 2 2 2 2 2 2 2 2 2 2 2 2 2 2 2 2 2 2 2 2 2 2
2 2 2 2 2 2 2 2 2 2 2 2 2 2 2 2 2 2 2 2 2 2 2 2 2 2 2 2 2 2

