32 22
260 704
2 2 2 2 2 2 2 2 2 2 2 2 2 2 2 2 2 2 2 2 2 2 2 2 2 2 2 2 2 2 2 2
2 2 2 2 2 2 2 2 2 2 2 2 2 2 2 2 2 2 2 2 2 2 2 2 2 2 2 2 2 2 2 2
2 2 2 2 2 2 2 2 14 11 11 11 11 11 11 11 11 11 11 11 11 11 11 14 2 2 2 2 2 2 2 2
2 2 2 2 2 2 2 2 14 0 0 0 0 0 0 0 0 0 0 0 0 0 0 14 2 2 2 2 2 2 2 2
2 2 2 2 2 2 2 2 14 0 0 0 0 0 0 0 0 0 0 0 0 0 0 14 2 2 2 2 2 2 2 2
2 2 2 2 2 2 2 2 14 0 0 14 14 0 0 14 14 0 0 14 14 0 0 14 2 2 2 2 2 2 2 2
2 2 2 2 2 2 2 2 14 0 0 11 11 0 0 11 11 0 0 11 11 0 0 14 2 2 2 2 2 2 2 2
2 2 14 11 11 11 14 2 14 0 0 0 0 0 0 0 0 0 0 0 0 0 0 14 2 14 11 0 11 14 2 2
2 2 14 0 0 0 14 2 14 0 0 0 0 0 0 0 0 0 0 0 0 0 0 14 2 14 0 0 0 14 2 2
2 2 14 0 0 0 11 11 11 0 0 0 0 0 0 0 0 0 0 0 0 0 0 11 11 11 0 0 0 14 2 2
2 2 14 0 0 0 0 0 0 0 0 0 0 0 0 0 0 0 0 0 0 0 0 0 0 0 0 0 0 14 2 2
2 2 14 0 0 0 0 0 0 0 0 0 0 0 0 0 0 0 0 0 0 0 0 0 0 0 0 0 0 14 2 2
2 2 14 0 0 0 14 14 14 0 0 0 0 0 0 0 0 0 0 0 0 0 0 14 11 14 0 0 0 14 2 2
2 2 14 0 0 0 14 2 14 0 0 0 0 0 0 0 0 0 0 0 0 0 0 14 2 14 0 0 0 14 2 2
2 2 11 11 11 11 11 2 14 0 0 0 0 0 0 0 0 0 0 0 0 0 0 14 2 11 11 11 11 11 2 2
2 2 2 2 2 2 2 2 14 0 0 14 14 0 0 14 14 0 0 14 14 0 0 14 2 2 2 2 2 2 2 2
2 2 2 2 2 2 2 2 14 0 0 11 11 0 0 11 11 0 0 11 11 0 0 14 2 2 2 2 2 2 2 2
2 2 2 2 2 2 2 2 14 0 0 0 0 0 0 0 0 0 0 0 0 0 0 14 2 2 2 2 2 2 2 2
2 2 2 2 2 2 2 2 14 0 0 0 0 0 0 0 0 0 0 0 0 0 0 14 2 2 2 2 2 2 2 2
2 2 2 2 2 2 2 2 11 11 11 11 11 11 11 11 11 11 11 11 11 11 11 11 2 2 2 2 2 2 2 2
2 2 2 2 2 2 2 2 2 2 2 2 2 2 2 2 2 2 2 2 2 2 2 2 2 2 2 2 2 2 2 2
2 2 2 2 2 2 2 2 2 2 2 2 2 2 2 2 2 2 2 2 2 2 2 2 2 2 2 2 2 2 2 2